NO  img/no.xpm
SO img/so.xpm
WE img/we.xpm
EA img/ea.xpm
    
F 98,105,109
C 80,130,200



111
101
1N11
11111
