NO  img/ael-bekk.xpm
SO img/mel-hada.xpm
WE img/mabenchi.xpm
EA img/zboudair.xpm
    
F 98,105,109
C 80,130,200



11111
10001
1N001
11111