NO  img/ael-bekk.xpm
SO img/mel-hada.xpm
WE img/mabenchi.xpm
EA img/zboudair.xpm
        
F 98,105,109


C 80,130,200





    11111111111111111111111111         
   10000000000000000000001  
  1000000000000001000000001
 10000000000000000000000001
1000000000000000000000001
 1000000000001000000000001
  1000000000000000000000001
   1000000000000000000000001
  1000000000000000000000001
 100000000000N000000000001
1111111111111111111111111