NO  img/ael-bekk.xpm
SO img/mel-hada.xpm
WE img/mabenchi.xpm
EA img/zboudair.xpm
    
F 98,105,109
C 80,130,200



111
11
1N11
11111
